------oooooo
--F---ooIoio
-G----ooWooo
------oooowo
--g---oooooo
------------
---XP---f---
------------
----E---e---